NO textures/cobble.xpm
SO textures/dirt.xpm
EA textures/gold.xpm
WE textures/wood.xpm
C 220, 220, 220
F 50, 50, 50

1111111111111
100001    1001
1000001111101
10000100010001
1000001110N01
100000000001
100000000011
1000000000001
12111111111111
10000011
101011001
11111111111
